#######
#Q....#
#.###.#
#.#...#
#.#.#.#
#...E.#
#######