#####
#Q#.#
#.#.#
#.#E#
#####
