#################
#Q##############E
#.#.#.#.#.#.#.#.#
#.#.#.#.#.#.#.#.#
#.#.#.#.#.#.#.#.#
#.#.#.#.#.#.#.#.#
#.#.#.#.#.#.#.#.#
#.#.#.#.#.#.#.#.#
#.#.#.#.#.#.#.#.#
#.#.#.#.#.#.#.#.#
#.#.#.#.#.#.#.#.#
#.#.#.#.#.#.#.#.#
#.#.#.#.#.#.#.#.#
#.#.#.#.#.#.#.#.#
#.#.#.#.#.#.#.#.#
#.#.#.#.#.#.#.#.#
#################