###############
#E.......#....#
###.###.#.#.###
#...#...#.#.#.#
#.#####.#.#.#.#
#.#.....#.#.#.#
#.#.###.#.#.#.#
#.#.#...#.#.#.#
#.#.#.###.#.#.#
#.#.#.#...#.#.#
#.#.#.#.#.###.#
#...#.#.#.....#
###.###.#####.#
#Q.............#
###############