#########
#Q.#....#
#.......#
#...#.###
#...#...#
#########