#########
#..#....#
#.......#
#...#####
#Q..#..E#
#########