#########
#..#...Q#
#.......#
#...#.###
#...#..E#
#########