######
#...X#
#.#.##
#3.4.#
######