######
#...X#
#.####
#....#
######
