#############
#...Y#....#X#
#.#.###.#.#.#
#...........#
#############